222x22222222122222222x222
2xxxxx2wwwww1wwwww2xxxxx2
2222222w222212222w2222222
2zz2zz211w1x1x1w112zz2zz2
2zz2zz211w11111w112zz2zz2
1111111x1w1x1x1w1x1111111
2wwwww21w1111111w12wwwww2
1111111w111x1x111w1111111
2zz2zz211w11x11w112zz2zz2
2z222z2x1x1x1x1x1x2z222z2
2222222222221222222222222
2zzzzz2w2ww212ww2w2zzzzz2
222222222w22122w222222222