wwwwwwwwwwwww
w11z11111z11w
w1z1z1x1z1z1w
w111w111w111w
w1w1x1x1x1w1w
wz1111w1111zw
w1w1x111x1w1w
w111w1w1w111w
wzz1z111z1zzw
w11111z11111w
wwwwwwwwwwwww